"filename", "language", "JSON", "CSS", "JavaScript", "HTML", "Properties", "comment", "blank", "total"
"c:\Users\rudom.PENETRATOR\OneDrive\Documents\html\work\sport-live\package-lock.json", "JSON", 6, 0, 0, 0, 0, 0, 1, 7
"c:\Users\rudom.PENETRATOR\OneDrive\Documents\html\work\sport-live\server\.env", "Properties", 0, 0, 0, 0, 10, 0, 1, 11
"c:\Users\rudom.PENETRATOR\OneDrive\Documents\html\work\sport-live\server\controllers\api\auth-controller.js", "JavaScript", 0, 0, 70, 0, 0, 1, 9, 80
"c:\Users\rudom.PENETRATOR\OneDrive\Documents\html\work\sport-live\server\controllers\api\index.js", "JavaScript", 0, 0, 8, 0, 0, 0, 2, 10
"c:\Users\rudom.PENETRATOR\OneDrive\Documents\html\work\sport-live\server\controllers\api\lk-controller.js", "JavaScript", 0, 0, 181, 0, 0, 1, 16, 198
"c:\Users\rudom.PENETRATOR\OneDrive\Documents\html\work\sport-live\server\controllers\api\match\index.js", "JavaScript", 0, 0, 68, 0, 0, 0, 5, 73
"c:\Users\rudom.PENETRATOR\OneDrive\Documents\html\work\sport-live\server\controllers\api\player\index.js", "JavaScript", 0, 0, 66, 0, 0, 0, 5, 71
"c:\Users\rudom.PENETRATOR\OneDrive\Documents\html\work\sport-live\server\controllers\api\team\index.js", "JavaScript", 0, 0, 66, 0, 0, 0, 5, 71
"c:\Users\rudom.PENETRATOR\OneDrive\Documents\html\work\sport-live\server\controllers\api\tournament\index.js", "JavaScript", 0, 0, 67, 0, 0, 2, 5, 74
"c:\Users\rudom.PENETRATOR\OneDrive\Documents\html\work\sport-live\server\controllers\index.js", "JavaScript", 0, 0, 16, 0, 0, 0, 2, 18
"c:\Users\rudom.PENETRATOR\OneDrive\Documents\html\work\sport-live\server\dtos\user-dto.js", "JavaScript", 0, 0, 10, 0, 0, 0, 2, 12
"c:\Users\rudom.PENETRATOR\OneDrive\Documents\html\work\sport-live\server\exceptions\api-error.js", "JavaScript", 0, 0, 18, 0, 0, 0, 3, 21
"c:\Users\rudom.PENETRATOR\OneDrive\Documents\html\work\sport-live\server\index.js", "JavaScript", 0, 0, 50, 0, 0, 19, 12, 81
"c:\Users\rudom.PENETRATOR\OneDrive\Documents\html\work\sport-live\server\middlewares\auth-middleware.js", "JavaScript", 0, 0, 20, 0, 0, 0, 6, 26
"c:\Users\rudom.PENETRATOR\OneDrive\Documents\html\work\sport-live\server\middlewares\checkAuth-middleware.js", "JavaScript", 0, 0, 27, 0, 0, 0, 2, 29
"c:\Users\rudom.PENETRATOR\OneDrive\Documents\html\work\sport-live\server\middlewares\error-middleware.js", "JavaScript", 0, 0, 8, 0, 0, 0, 3, 11
"c:\Users\rudom.PENETRATOR\OneDrive\Documents\html\work\sport-live\server\models\judge-model.js", "JavaScript", 0, 0, 4, 0, 0, 1, 3, 8
"c:\Users\rudom.PENETRATOR\OneDrive\Documents\html\work\sport-live\server\models\match-model.js", "JavaScript", 0, 0, 11, 0, 0, 0, 3, 14
"c:\Users\rudom.PENETRATOR\OneDrive\Documents\html\work\sport-live\server\models\player-model.js", "JavaScript", 0, 0, 9, 0, 0, 0, 3, 12
"c:\Users\rudom.PENETRATOR\OneDrive\Documents\html\work\sport-live\server\models\representative-model.js", "JavaScript", 0, 0, 9, 0, 0, 0, 3, 12
"c:\Users\rudom.PENETRATOR\OneDrive\Documents\html\work\sport-live\server\models\season-model.js", "JavaScript", 0, 0, 8, 0, 0, 1, 3, 12
"c:\Users\rudom.PENETRATOR\OneDrive\Documents\html\work\sport-live\server\models\stadium-model.js", "JavaScript", 0, 0, 8, 0, 0, 1, 3, 12
"c:\Users\rudom.PENETRATOR\OneDrive\Documents\html\work\sport-live\server\models\team-model.js", "JavaScript", 0, 0, 11, 0, 0, 0, 3, 14
"c:\Users\rudom.PENETRATOR\OneDrive\Documents\html\work\sport-live\server\models\token-model.js", "JavaScript", 0, 0, 6, 0, 0, 0, 3, 9
"c:\Users\rudom.PENETRATOR\OneDrive\Documents\html\work\sport-live\server\models\tournament-model.js", "JavaScript", 0, 0, 47, 0, 0, 0, 3, 50
"c:\Users\rudom.PENETRATOR\OneDrive\Documents\html\work\sport-live\server\models\transfer-model.js", "JavaScript", 0, 0, 8, 0, 0, 1, 3, 12
"c:\Users\rudom.PENETRATOR\OneDrive\Documents\html\work\sport-live\server\models\user-model.js", "JavaScript", 0, 0, 9, 0, 0, 0, 3, 12
"c:\Users\rudom.PENETRATOR\OneDrive\Documents\html\work\sport-live\server\models\userD-model.js", "JavaScript", 0, 0, 8, 0, 0, 0, 3, 11
"c:\Users\rudom.PENETRATOR\OneDrive\Documents\html\work\sport-live\server\navs\constant.js", "JavaScript", 0, 0, 108, 0, 0, 3, 6, 117
"c:\Users\rudom.PENETRATOR\OneDrive\Documents\html\work\sport-live\server\navs\index.js", "JavaScript", 0, 0, 7, 0, 0, 0, 2, 9
"c:\Users\rudom.PENETRATOR\OneDrive\Documents\html\work\sport-live\server\package-lock.json", "JSON", 2360, 0, 0, 0, 0, 0, 1, 2361
"c:\Users\rudom.PENETRATOR\OneDrive\Documents\html\work\sport-live\server\package.json", "JSON", 31, 0, 0, 0, 0, 0, 1, 32
"c:\Users\rudom.PENETRATOR\OneDrive\Documents\html\work\sport-live\server\router\auth-router.js", "JavaScript", 0, 0, 16, 0, 0, 0, 2, 18
"c:\Users\rudom.PENETRATOR\OneDrive\Documents\html\work\sport-live\server\router\index.js", "JavaScript", 0, 0, 10, 0, 0, 0, 2, 12
"c:\Users\rudom.PENETRATOR\OneDrive\Documents\html\work\sport-live\server\router\lk-router.js", "JavaScript", 0, 0, 11, 0, 0, 0, 2, 13
"c:\Users\rudom.PENETRATOR\OneDrive\Documents\html\work\sport-live\server\service\mail-service.js", "JavaScript", 0, 0, 30, 0, 0, 0, 5, 35
"c:\Users\rudom.PENETRATOR\OneDrive\Documents\html\work\sport-live\server\service\token-service.js", "JavaScript", 0, 0, 47, 0, 0, 0, 8, 55
"c:\Users\rudom.PENETRATOR\OneDrive\Documents\html\work\sport-live\server\service\user-service.js", "JavaScript", 0, 0, 69, 0, 0, 1, 13, 83
"c:\Users\rudom.PENETRATOR\OneDrive\Documents\html\work\sport-live\server\views\auth.ejs", "HTML", 0, 0, 0, 7, 0, 0, 1, 8
"c:\Users\rudom.PENETRATOR\OneDrive\Documents\html\work\sport-live\server\views\contact.ejs", "HTML", 0, 0, 0, 21, 0, 0, 2, 23
"c:\Users\rudom.PENETRATOR\OneDrive\Documents\html\work\sport-live\server\views\global\footer.ejs", "HTML", 0, 0, 0, 2, 0, 0, 0, 2
"c:\Users\rudom.PENETRATOR\OneDrive\Documents\html\work\sport-live\server\views\global\header.ejs", "HTML", 0, 0, 0, 15, 0, 0, 0, 15
"c:\Users\rudom.PENETRATOR\OneDrive\Documents\html\work\sport-live\server\views\lk.ejs", "HTML", 0, 0, 0, 8, 0, 0, 0, 8
"c:\Users\rudom.PENETRATOR\OneDrive\Documents\html\work\sport-live\server\views\partials\dashboard_nav.ejs", "HTML", 0, 0, 0, 14, 0, 0, 1, 15
"c:\Users\rudom.PENETRATOR\OneDrive\Documents\html\work\sport-live\server\views\partials\lk_main.ejs", "HTML", 0, 0, 0, 2, 0, 0, 1, 3
"c:\Users\rudom.PENETRATOR\OneDrive\Documents\html\work\sport-live\server\views\partials\lk_part\match.ejs", "HTML", 0, 0, 0, 35, 0, 0, 3, 38
"c:\Users\rudom.PENETRATOR\OneDrive\Documents\html\work\sport-live\server\views\partials\lk_part\match_create.ejs", "HTML", 0, 0, 0, 22, 0, 0, 3, 25
"c:\Users\rudom.PENETRATOR\OneDrive\Documents\html\work\sport-live\server\views\partials\lk_part\player.ejs", "HTML", 0, 0, 0, 35, 0, 0, 4, 39
"c:\Users\rudom.PENETRATOR\OneDrive\Documents\html\work\sport-live\server\views\partials\lk_part\profile.ejs", "HTML", 0, 0, 0, 14, 0, 0, 1, 15
"c:\Users\rudom.PENETRATOR\OneDrive\Documents\html\work\sport-live\server\views\partials\lk_part\team.ejs", "HTML", 0, 0, 0, 37, 0, 0, 3, 40
"c:\Users\rudom.PENETRATOR\OneDrive\Documents\html\work\sport-live\server\views\partials\lk_part\team_create.ejs", "HTML", 0, 0, 0, 12, 0, 0, 2, 14
"c:\Users\rudom.PENETRATOR\OneDrive\Documents\html\work\sport-live\server\views\partials\lk_part\team_list.ejs", "HTML", 0, 0, 0, 36, 0, 0, 4, 40
"c:\Users\rudom.PENETRATOR\OneDrive\Documents\html\work\sport-live\server\views\partials\lk_part\team_list_create.ejs", "HTML", 0, 0, 0, 12, 0, 0, 1, 13
"c:\Users\rudom.PENETRATOR\OneDrive\Documents\html\work\sport-live\server\views\partials\lk_part\tournament.ejs", "HTML", 0, 0, 0, 34, 0, 0, 3, 37
"c:\Users\rudom.PENETRATOR\OneDrive\Documents\html\work\sport-live\server\views\partials\lk_part\tournament_create.ejs", "HTML", 0, 0, 0, 32, 0, 0, 3, 35
"c:\Users\rudom.PENETRATOR\OneDrive\Documents\html\work\sport-live\server\views\partials\lk_part\tournament_edit.ejs", "HTML", 0, 0, 0, 30, 0, 0, 3, 33
"c:\Users\rudom.PENETRATOR\OneDrive\Documents\html\work\sport-live\server\views\partials\loginForm.ejs", "HTML", 0, 0, 0, 10, 0, 0, 0, 10
"c:\Users\rudom.PENETRATOR\OneDrive\Documents\html\work\sport-live\server\views\partials\regForm.ejs", "HTML", 0, 0, 0, 12, 0, 0, 0, 12
"c:\Users\rudom.PENETRATOR\OneDrive\Documents\html\work\sport-live\static\lib\css\calendarorganizer.min.css", "CSS", 0, 1, 0, 0, 0, 0, 0, 1
"c:\Users\rudom.PENETRATOR\OneDrive\Documents\html\work\sport-live\static\lib\css\jsCalendar.min.css", "CSS", 0, 1, 0, 0, 0, 5, 2, 8
"c:\Users\rudom.PENETRATOR\OneDrive\Documents\html\work\sport-live\static\lib\css\vanillaCalendar.css", "CSS", 0, 100, 0, 0, 0, 0, 15, 115
"c:\Users\rudom.PENETRATOR\OneDrive\Documents\html\work\sport-live\static\lib\js\calendarorganizer.min.js", "JavaScript", 0, 0, 1, 0, 0, 0, 0, 1
"c:\Users\rudom.PENETRATOR\OneDrive\Documents\html\work\sport-live\static\lib\js\jsCalendar.lang.ru.js", "JavaScript", 0, 0, 39, 0, 0, 15, 6, 60
"c:\Users\rudom.PENETRATOR\OneDrive\Documents\html\work\sport-live\static\lib\js\vanillaCalendar.js", "JavaScript", 0, 0, 111, 0, 0, 3, 13, 127
"c:\Users\rudom.PENETRATOR\OneDrive\Documents\html\work\sport-live\static\pages\lk.js", "JavaScript", 0, 0, 136, 0, 0, 0, 6, 142
"c:\Users\rudom.PENETRATOR\OneDrive\Documents\html\work\sport-live\static\pages\login.js", "JavaScript", 0, 0, 23, 0, 0, 0, 1, 24
"c:\Users\rudom.PENETRATOR\OneDrive\Documents\html\work\sport-live\static\pages\parts\team.js", "JavaScript", 0, 0, 2, 0, 0, 0, 1, 3
"c:\Users\rudom.PENETRATOR\OneDrive\Documents\html\work\sport-live\static\script.js", "JavaScript", 0, 0, 234, 0, 0, 29, 46, 309
"c:\Users\rudom.PENETRATOR\OneDrive\Documents\html\work\sport-live\static\styles\lk.css", "CSS", 0, 24, 0, 0, 0, 0, 3, 27
"c:\Users\rudom.PENETRATOR\OneDrive\Documents\html\work\sport-live\static\styles\style.css", "CSS", 0, 67, 0, 0, 0, 1, 6, 74
"Total", "-", 2397, 193, 1657, 390, 10, 84, 291, 5022